
NO ./textures/redbrick.xpm 
SO ./textures/redbrick.xpm      
WE ./textures/redbrick.xpm 
EA ./textures/floor_overlook_hotel_1.xpm


     C   125,125,135
F 125,125,135


1111111111111111111111
1000000000000001111101
100000000E000001111001
1000000000000001111111
1000000000000000001001
1000000111111100000001
1000000000100000000111
1000001111110000000001
1111111    11111111111