        NO       ./textures/overlook_carpet.xpm

          SO ./textures/overlook_carpet.xpm     
          WE ./textures/overlook_carpet.xpm
       EA ./textures/overlook_carpet.xpm


    C 125,125,135
F 125,125,135





1111111111111111111111
1000000W00000001111101
1000000000000001111001
1000000000000001111111
1000000000000000001001
1111111111111111111111


1111111111111111111111
1000000111111100000001
1000000000100000000111
1000001111110000000001
1111111    11111111111