NO ./textures/floor_overlook_hotel_1.xpm
SO ./t extures/floor_overlook_hotel_2.xpm      
WE ./textures/floor_overlook_hotel_1.xpm 
EA ./textures/floor_overlook_hotel_2.xpm

F 220,100,2
C 225,30,2

1111111111111111111111
1000000000000000000001
1000000000000000000001
1000000000000000000001
1000000000000001111111
100W000000000001111001
1000000000000001111111
1000000000000000001001
1000000111111100000001
1000000000100000000111
1000000000000000000001
1111111111111111111111