NO ./textures/floor_overlook_hotel_1.xpm
SO ./t extures/floor_overlook_hotel_2.xpm      
WE ./textures/floor_overlook_hotel_1.xpm 
EA ./textures/floor_overlook_hotel_2.xpm

F 220,100,2
C 225,30,2

111111111111111111111111111111111111111
100000000000000000000000000000000000011
100000000000000000000000000000000000011
100000000000000000000000000000000000011
100000000000000111111000000000000000011
100000000000000111100000000000000000011
100000000000000000000000000000111111111
10000000000000000010000000000000111111
10000000000000000000N000000000000000011
10000001111111000000000000000000000011
10000000000000000000000001110000000011
100000000000000000000000000000000000011
111111111111111111111111111111111111111