
NO ./textures/redbrick.xpm 
SO ./t extures/redbrick.xpm      
WE ./textures/redbrick.xpm 
EA ./textures/redbrick.xpm
        NO         ./textures/overlook_carpet.xpm 



          SO ./tex tures/test.xpm     
          WE ./textures/overlook_carpet.xpm
       EA ./textures/overlook_carpet.xpm

     C   125,125,135
F 125,125,135


1111111111111111111111
1000000W00000001111101
1000000000000001111001
1000000000000001111111
1000000000000000001001
1000000111111100000001
1000000000100000000111
1000001111110000000001
1111111    111111111111