        NO         ./textures/overlook_carpet.xpm 



          SO ./textures/overlook_carpet.xpm     
          WE ./textures/overlook_carpet.xpm
       EA ./textures/overlook_carpet.xpm

C 125,125,135
F 125,125,135


1111111
    
1111111
10000E1
1111111
 
1111111
1111111
