NO ./textures/wallpaper_flowers.xpm 
SO ./t extures/wallpaper_flowers.xpm      
WE ./textures/wallpaper_flowers.xpm 
EA ./textures/wallpaper_flowers.xpm

C 128,128,133
F 255,0,127

1111111111111111111111
1000000000000000000001
1000000000000000000001
1000000000000000000001
1000000S00000001111111
1000000000000001111001
1000000000000001111111
1000000000000000001001
1000000111111100000001
1000000000100000000111
1000000000000000000001
1111111111111111111111