NO ./textures/flower_wallpaper_light.xpm
WE ./textures/wallpaper_flowers_blue_light.xpm
SO ./textures/wallpaper_flowers_blue_shadow.xpm
EA ./textures/flower_wallpaper_shadow.xpm

F 164,118,83
C 230,225,215

1111111111111111111111
10000000000000011111 1
100000000S000001111  1
1000000000000001111111
1000000000000000001001    1111
10000000000000000000001   1001
1000000111111100000001    1111
1000000000100000001111
1000000000000000000001
1111111111111111111111