NO ./textures/floor_overlook_hotel_1.xpm
SO ./t extures/floor_overlook_hotel_2.xpm      
WE ./textures/floor_overlook_hotel_1.xpm 
EA ./textures/floor_overlook_hotel_2.xpm

F -10,100,2
C 255,100,2

111111111111
1E00000001
11111111111