
NO ./textures/greystone.xpm
SO ./textures/redbrick.xpm
EA ./textures/wood.xpm
WE ./textures/wood.xpm

C 055,000,160
F 100,100,100

01111111111111111
10000000000000001
10000000000000001
10000000000000001
10000000000000001
10000000W00000001
10000000000000001
10000000000000001
10000000000000001
10000000000000001
10000000000000001
10000000000000001
11111111111111111
