NO ./textures/floor_overlook_hotel_1.xpm
SO ./t extures/floor_overlook_hotel_2.xpm      
WE ./textures/floor_overlook_hotel_1.xpm 
EA ./textures/floor_overlook_hotel_2.xpm
F 220,100,2
C 225,30,2

1111111
1000001
1000001     
1000001
111111E